(6, 6)
# ####
#    #
#### #
#    #
#    #
# ####